ability - the physical or mental power or skill needed to do something
account - an arrangement with a bank to keep your money there
activity - the work of a group or organization to achieve an aim
address - the number of the house, name of the road, and town where a person lives
advice - an opinion that someone offers you about what you should do
agree - to have the same opinion
beautiful - very attractive
because - for the reason that
believe - to think that something is true, correct, or real
benefit - a helpful or good effect, or something intended to help
better - of a higher standard, or more suitable, pleasing, or effective
business - the activity of buying and selling goods and services
camera - a device for taking photographs or making films
capital - a city that is the center of government of a country
center - the middle point or part of something
century - a period of 100 years
chance - an occasion that allows something to be done
change - to exchange one thing for another thing
daughter - a person's female child
decide - to choose something after thinking carefully about several possibilities
degree - a course of study at a college or university
design - to make or draw plans for something, like clothes or buildings
detail - a single piece of information or fact about something
discover - to find information, a place, or an object for the first time
early - near the beginning of a period of time
economy - the system of trade and industry by which the wealth of a country is made
education - the process of teaching or learning, especially in a school or college
effect - the result of a particular influence
effort - physical or mental activity needed to achieve something
energy - the power from things such as electricity or coal that makes machines work
family - a group of people who are related to each other
famous - known and recognized by many people
field - an area of land, used for growing crops or keeping animals
figure - a number or an amount
finally - after a long time or some difficulty
finish - to complete something or come to the end of an activity
garden - a piece of land next to a house, used for growing flowers or vegetables
general - involving or relating to most or all people, things, or places
glass - a hard, transparent material used to make windows and bottles
ground - the surface of the earth
group - a number of people or things that are put together or considered as a unit
growth - the process of increasing in size
happen - to take place, especially without being planned
health - the condition of the body and the degree to which it is free from illness
history - the study of or a record of past events
holiday - a time when you do not have to go to work or school
hospital - a place where people who are ill or injured are treated and taken care of
human - being, relating to, or belonging to a person
idea - a suggestion or plan for doing something
image - a picture in your mind or a photograph
impact - the powerful effect that something has on a situation or person
important - necessary or of great value
improve - to get better or to make something better
include - to contain something as a part of something else
jacket - a short coat
join - to connect or fasten things together
journey - the act of traveling from one place to another
judge - a person who is in charge of a court of law
juice - the liquid that comes from fruit or vegetables
jump - to push yourself suddenly off the ground using your legs
keep - to continue to have or own something
keyboard - the set of keys on a computer or musical instrument
kick - to hit something with your foot
kill - to cause someone or something to die
kind - generous, helpful, and thinking about other people's feelings
kitchen - a room where food is kept, prepared, and cooked
language - a system of communication used by a particular country or community
laptop - a computer that is small enough to be carried around and used on your lap
large - big in size or amount
laugh - to smile and make sounds with your voice because you think something is funny
leader - a person in control of a group, country, or situation
learn - to get knowledge or skill in a new subject or activity
magazine - a type of thin book with large pages and a paper cover that contains articles and photographs
mainly - mostly or to a large degree
maintain - to continue to have; to keep in existence
manage - to be responsible for controlling or organizing someone or something
market - the business or activity of buying and selling goods
matter - a situation or subject that is being dealt with or considered
national - relating to the whole of a nation or country
natural - as found in nature and not involving anything made by people
nature - all the animals, plants, rocks, etc. in the world and all the features and forces that are not made by people
nearly - almost, or not quite
necessary - needed in order to achieve a particular result
network - a system of parts that are connected to each other
object - a physical thing that can be seen and touched
obvious - easy to see, recognize, or understand
occasion - a particular time, especially when something happens or has happened
ocean - a very large area of sea
offer - to ask someone if they would like to have something or if they would like you to do something
office - a room or building where people work
parent - a mother or father of a person or an animal
partner - a person or organization you are closely involved with in some way
party - a social event where a group of people meet to talk, eat, drink, dance, etc.
patient - a person who is receiving medical care
pattern - a particular way in which something is done, is organized, or happens
peace - a state of calm or quiet
quality - how good or bad something is
quantity - the amount or number of something
quarter - one of four equal or almost equal parts of something
queen - a female ruler of a country
question - a sentence or phrase used to find out information
quick - happening or done with great speed
radio - the system of sending and receiving signals through the air using electromagnetic waves
raise - to lift something to a higher position
range - a set of similar things
rather - quite; to a slight degree
reach - to arrive at a place, especially after spending a long time or a lot of effort traveling
reality - the state of things as they are, rather than as they are imagined to be
safety - a state in which or a place where you are safe and not in danger
salary - a fixed amount of money agreed every year as pay for an employee
sample - a small amount of something that shows you what the rest is like
sauce - a thick liquid eaten with food to add flavor
scene - a part of a play or film in which the action stays in one place
schedule - a list of planned activities or things to be done showing the times when they are intended to happen
target - one or more people or things that you are trying to influence
taste - the flavor of something, or the ability of a person or animal to recognize different flavors
teacher - someone whose job is to teach in a school or college
team - a number of people or animals who do something together as a group
technical - relating to the practical use of machines, methods, or systems in science and industry
technology - the practical, especially industrial, use of scientific discoveries
unable - not able to do something
uncle - the brother of someone's mother or father, or the husband of someone's aunt
under - in or to a position below or lower than something else
unit - a single thing or a separate part of something larger
university - a place of higher education usually for students from age 18
until - up to the time that
vacation - a time when someone does not go to work or school but is free to do what they want
valley - an area of low land between hills or mountains
value - the amount of money that can be received for something
variety - a characteristic of having many different types of things
vehicle - a machine, usually with wheels and an engine, used for transporting people or goods
victim - someone or something that has been hurt, damaged, or killed
weight - the amount that something or someone weighs
welcome - to meet and speak to someone in a friendly way when they arrive
wheel - a circular object connected at the center to a bar, used for making vehicles or parts of machines move
whole - complete or not divided
window - a space in the wall of a building or vehicle that has glass in it
winter - the coldest season of the year
yellow - a color like that of a lemon or gold
yesterday - on the day before today
young - having lived or existed for only a short time
yourself - used when the object of a verb or preposition is the same person as the subject
youth - the period of your life when you are young
zero - the number 0
zone - an area, especially one that is different from the areas around it